R 1920 600
NO ./images/mur_N.xpm
SO ./images/mur_S.xpm
WE ./images/mur_W.xpm
EA ./images/mur_E.xpm
S ./images/column.xpm
F 120,120,120
C 47,79,79

1111111111
1000000201
10E0000201
1000000001
1111111111
