R 492 492

NO        ./textures/NO_wood.xpm
SO         ./textures/SO_stone.xpm
WE        ./textures/WE_wood.xpm
EA           ./textures/EA_dirt.xpm

S    ./textures/barrel.xpm

F     120,255,120
C      120,120,255

11111111111111111111111111111  111
1002220000110000000000100000111101
100000000111000000000101000100001
10010N0000000000000000101000111111
10110000011100000001000000001
10000000001100000111011110001
111101111111110111000000100011111
111101111111110111010100100011111
11000000110101011100000010001
10000000000000001100000010001
10000000000000001101010010001
11000000110101011111011110001
11110111111101011111111110001
11111111111111111111111110001
                        10001
          1111          10001
          1001          10001
          1111          11111



